9
19
###############.###
#                 #
# #################
#             #   #
# ### ##### # # # #
#   # #   # # # # #
# # # ### # # # # #
# # #     #     # #
###########X#######